NO textures/simonkraft/respawn_anchor_side0.xpm
EA textures/simonkraft/respawn_anchor_side2.xpm
SO textures/simonkraft/respawn_anchor_side4.xpm
WE textures/simonkraft/respawn_anchor_side3.xpm

C 35,19,73
F 15,6,40

111111111111111111111111111111111111111111111111111111111111111111111111111111
100000000000000000000000000000000000100000000000000000010000000000000000000001
101111111111111101111111111111111110101111111111111111110011111111111111111101
101000000000000000000000000000000000100000000000000000000000000000000000000101
101011111111111101011111111111111101111111111111111111111111111111111111111101
100000000000000000000000000000000000000000000000000000000000000000000000000001
101111111111111011111100000011111101111111111111011111111101100011111111111001
100000000000000000000000000000000000000000000000000000000000000000000000000001
101011111111111011111111111110111111111111011111111111011111111111101111011111
100000000000000000000000000000000000000000000000000000000000000000111101111101
1010000000000000000000000000000N0000100000000000000000000000000000000000000001
111111111111111111111111111111111111111111111111111111111111111111111111111111