F 139,99,58
C 171,154,137

NO textures/simonkraft/bookshelf.xpm
SO textures/simonkraft/bookshelf_01.xpm
WE textures/simonkraft/bookshelf_02.xpm
EA textures/simonkraft/bookshelf_03.xpm

111111111111111
1S0000000000001
101111111111101
101000000000101
101000000000001
101111111111101
100000000000001
111111111111111